1,1,1,1,1,1,1,1,1,1,1,1,1,1,1,1,1,1,1,1,1,1,1,1,1,1,
1,0,0,0,0,0,0,0,0,0,0,0,0,0,0,0,0,0,0,0,0,0,0,0,1,1,
1,0,0,0,0,0,0,0,0,0,0,0,0,0,0,0,0,0,0,0,0,0,0,0,1,1,
1,0,0,0,0,0,0,0,0,0,0,0,0,0,0,0,0,0,0,0,0,0,0,0,1,1,
1,0,0,0,0,0,0,0,0,0,0,0,0,0,0,0,0,0,0,0,0,0,0,0,1,1,
1,0,0,0,0,0,0,0,0,0,0,0,0,0,0,0,0,0,0,0,0,0,0,0,1,1,
1,0,0,0,0,0,0,0,0,0,0,0,0,0,0,0,0,0,0,0,0,0,0,0,1,1,
1,0,0,0,0,0,0,0,0,0,0,0,0,0,0,0,0,0,0,0,0,0,1,1,1,1,
1,0,0,0,0,0,0,0,0,0,0,0,0,0,0,0,0,0,0,0,0,0,0,0,1,1,
1,0,0,0,0,0,0,0,0,0,0,0,0,0,0,0,0,0,0,0,0,0,1,1,1,1,
1,0,0,0,0,0,0,0,0,0,0,0,0,0,0,0,0,0,0,0,0,0,0,0,1,1,
1,0,0,0,0,0,0,0,0,0,0,0,0,0,0,0,0,0,0,0,0,0,0,0,1,1,
1,0,0,0,0,0,0,0,0,0,0,0,0,0,0,0,0,0,0,0,0,0,0,0,1,1,
1,0,0,0,0,0,0,0,0,0,0,0,0,0,0,0,0,0,0,0,0,0,0,0,1,1,
1,0,0,0,0,0,0,0,0,0,0,0,0,0,0,0,0,0,0,0,0,0,0,0,1,1,
1,0,0,0,0,0,0,0,0,0,0,0,0,0,0,0,0,0,0,0,0,0,0,0,1,1,
1,1,1,1,1,1,1,1,1,1,1,1,1,1,1,1,1,1,1,1,1,1,1,1,1,1,
1,1,1,1,1,1,1,1,1,1,1,1,1,1,1,1,1,1,1,1,1,1,1,1,1,1,
~
2,1;
2,2;
2,3;
2,4;
2,5;
2,6;
2,7;
2,8;
2,9;
1,13;
1,15;
1,11;
2,11;
2,13;
2,15;
3,1;
3,11;
3,13;
3,15;
4,1;
4,3;
4,4;
4,5;
4,6;
4,7;
4,8;
4,9;
4,10;
4,11;
4,13;
4,15;
5,1;
5,3;
5,5;
5,7;
5,9;
5,11;
5,13;
5,15;
6,1;
7,1;
8,1;
9,1;
10,1;
11,1;
11,4;
11,5;
11,6;
11,7;
11,13;
11,15;
11,11;
13,11;
13,13;
13,15;
15,11;
15,13;
15,15;
17,11;
17,13;
17,15;
19,11;
19,13;
19,15;
21,11;
21,15;
21,13;
23,11;
23,13;
23,15;
17,5;
17,7;
19,5;
19,7;
21,5;
21,7;
23,5;
12,1;
13,1;
13,4;
13,8;
13,5;
13,6;
13,7;
15,4;
15,2;
15,5;
15,6;
15,7;
16,7;
17,7;
14,1;
15,1;
17,1;
19,1;
21,1;
23,1;
21,8;
22,8;
20,8;
19,8;
18,8;
23,8;
21,9;
20,9;
19,9;
18,9;
21,7;
20,7;
19,7;
18,7;
6,3;
7,3;
7,5;
7,7;
7,9;
7,11;
7,13;
7,15;
8,3;
9,3;
11,3;
11,2;
13,3;
15,3;
17,3;
19,3;
21,3;
23,3;
9,4;
9,5;
9,6;
9,7;
9,8;
9,9;
9,11;
9,13;
9,15;
10,9;
11,9;
12,9;
13,9;
14,9;
15,9;
16,9;
17,9